%%%%%%%%%
% . ... %
%.G.    %
%  .    %
%. .    %
%       %
%  .    %
%       %
%P  .   %
%%%%%%%%%
