%%%%%%%%%%%%%%
% . ...   .. %
%.G.  .....  %
%  . ....    %
%. .    ...  %
% ......  .  %
%  .  ..  .. %
%      ..... %
%P     ..... %
%%%%%%%%%%%%%%
